{
  "tileLayers": {
    "floor": {
      "tiles": [
        408, 408, 408, 408, 408, 408, 408, 408, 408, 408, 408, 408, 408, 408, 408, 408, 408, 408, 408, 408, 408, 408, 408, 408, 408, 408, 408, 408, 408, 408,
        408, 408, 408, 408, 408, 408, 408, 408, 408, 408, 408, 408, 408, 233, 234, 235, 241, 408, 408, 408, 408, 408, 408, 408, 408, 408, 408, 408, 408, 408,
        241, 233, 235, 291, 233, 235, 241, 293, 350, 234, 409, 241, 291, 291, 235, 234, 349, 234, 242, 409, 233, 350, 233, 350, 409, 291, 349, 291, 350, 241,
        241, 350, 409, 241, 292, 233, 235, 242, 293, 350, 234, 233, 349, 233, 241, 293, 349, 350, 409, 241, 292, 233, 235, 242, 293, 350, 234, 934, 349, 241,
        241, 242, 234, 349, 293, 242, 242, 233, 409, 235, 234, 241, 233, 293, 235, 291, 234, 242, 234, 349, 293, 242, 242, 233, 409, 235, 234, 241, 409, 241,
        241, 233, 235, 291, 233, 235, 241, 293, 350, 234, 409, 241, 291, 242, 409, 350, 233, 234, 242, 409, 233, 350, 233, 350, 234, 291, 349, 291, 350, 241,
        241, 242, 234, 349, 293, 242, 242, 233, 409, 235, 234, 241, 233, 293, 235, 291, 234, 242, 234, 349, 293, 242, 242, 233, 235, 235, 409, 241, 233, 241,
        241, 233, 235, 291, 233, 235, 241, 293, 350, 234, 409, 241, 291, 408, 408, 408, 408, 234, 242, 409, 233, 350, 233, 350, 409, 291, 349, 291, 350, 241,
        241, 350, 409, 241, 292, 233, 235, 242, 293, 350, 234, 233, 349, 408, 408, 408, 408, 350, 409, 241, 292, 233, 235, 242, 293, 350, 234, 233, 349, 241,
        241, 233, 234, 235, 241, 242, 233, 234, 235, 241, 242, 234, 235, 408, 408, 408, 408, 233, 234, 235, 233, 242, 233, 234, 235, 241, 242, 234, 235, 241,
        241, 242, 234, 349, 293, 242, 242, 233, 409, 235, 234, 241, 233, 408, 408, 408, 408, 291, 409, 350, 246, 244, 247, 247, 244, 248, 234, 241, 233, 241,
        241, 233, 234, 235, 241, 242, 233, 234, 235, 241, 242, 234, 235, 408, 408, 408, 408, 300, 300, 300, 304, 302, 305, 302, 302, 306, 300, 300, 300, 300,
        241, 350, 409, 241, 292, 233, 235, 242, 293, 350, 234, 233, 349, 408, 408, 408, 408, 300, 300, 300, 304, 305, 302, 302, 302, 306, 300, 300, 300, 300,
        241, 242, 234, 349, 293, 242, 242, 233, 409, 235, 234, 241, 233, 408, 408, 408, 408, 300, 300, 300, 304, 302, 302, 305, 305, 306, 300, 300, 300, 300,
        241, 233, 234, 235, 241, 242, 233, 234, 235, 241, 242, 234, 235, 408, 408, 408, 408, 300, 300, 242, 304, 302, 302, 302, 302, 306, 241, 300, 300, 300,
        241, 233, 235, 291, 233, 235, 241, 293, 350, 234, 409, 241, 291, 408, 408, 408, 408, 300, 300, 300, 304, 302, 305, 302, 302, 306, 300, 300, 300, 300,
        241, 242, 234, 349, 293, 242, 242, 233, 409, 235, 234, 241, 233, 408, 408, 408, 408, 242, 234, 349, 420, 421, 418, 421, 421, 422, 234, 241, 233, 233,
        241, 350, 409, 241, 292, 233, 235, 242, 293, 350, 234, 233, 349, 408, 408, 408, 408, 350, 409, 241, 292, 233, 235, 242, 293, 350, 234, 233, 349, 233,
        241, 233, 235, 291, 233, 235, 241, 293, 350, 234, 409, 241, 291, 408, 408, 408, 408, 234, 242, 409, 233, 350, 233, 350, 409, 291, 349, 291, 350, 233,
        241, 233, 235, 291, 233, 235, 241, 293, 350, 234, 409, 241, 291, 408, 408, 408, 408, 234, 242, 409, 233, 350, 233, 350, 409, 291, 349, 291, 350, 233,
        408, 408, 408, 408, 408, 408, 408, 408, 408, 408, 408, 408, 408, 408, 408, 408, 408, 408, 408, 408, 408, 408, 242, 233, 408, 408, 408, 408, 408, 408,
        408, 408, 408, 408, 408, 408, 408, 408, 408, 408, 408, 408, 408, 408, 408, 408, 408, 408, 408, 408, 408, 408, 408, 408, 408, 408, 408, 408, 408, 408
      ],
      "tileset": "dungeon"
    },
    "darkWalls": {
      "tiles": [
        698,   2,   3,   1,   2,   3,   1,   2,   3,   1,   2,   3,   1, 408, 408, 408, 408,   3,   1,   2,   3,  -1,  -1,  -1,  -1,  -1,   3,   1,   2, 699,
        756, 873, 873, 117, 120, 118, 120, 175, 120, 176, 120, 873, 872, 872, 872, 872, 872, 873, 872, 873, 873, 872, 873, 873, 872, 872, 872, 873, 872, 757,
         -1,  -1,  -1,  -1,  -1,  -1,  -1,   -1,  -1,  -1,  -1,  -1,  -1,  -1,  -1,  -1,  -1,  -1,  -1,  -1,  -1,  -1,  -1,  -1,  -1,  -1,  -1,  -1, -1,  -1,
         -1,  -1,  -1,  -1,  -1,  -1,  -1,   -1,  -1,  -1,  -1,  -1,  -1,  -1,  -1,  -1,  -1,  -1,  -1,  -1,  -1,  -1,  -1,  -1,  -1,  -1,  -1,  -1, -1,  -1,
         -1,  -1,  -1,  -1,  -1,  -1,  -1,   -1,  -1,  -1,  -1,  -1,  -1,  -1,  -1,  -1,  -1,  -1,  -1,  -1,  -1,  -1,  -1,  -1,  -1,  -1,  -1,  -1, -1,  -1,
         -1,  -1,  -1,  -1,  -1,  -1,  -1,   -1,  -1,  -1,  -1,  -1,  -1,  -1,  -1,  -1,  -1,  -1,  -1,  -1,  -1,  -1,  -1,  -1,  -1,  -1,  -1,  -1, -1,  -1,
         -1,  -1,  -1,  -1,  -1,  -1,  -1,   -1,  -1,  -1,  -1,  -1,  -1,  -1,  -1,  -1,  -1,  -1,  -1,  -1,  -1,  -1,  -1,  -1,  -1,  -1,  -1,  -1, -1,  -1,
         -1,  -1,  -1,  -1,  -1,  -1,  -1,   -1,  -1,  -1,  -1,  -1,  -1, 872, 872, 872, 872,  -1,  -1,  -1,  -1,  -1,  -1,  -1,  -1,  -1,  -1,  -1, -1,  -1,
         -1,  -1,  -1,  -1,  -1,  -1,  -1,   -1,  -1,  -1,  -1,  -1,  -1,  -1,  -1,  -1,  -1,  -1,  -1,  -1,  -1,  -1,  -1,  -1,  -1,  -1,  -1,  -1, -1,  -1,
         -1,  -1,  -1,  -1,  -1,  -1,  -1,   -1,  -1,  -1,  -1,  -1,  -1,  -1,  -1,  -1,  -1,  -1,  -1,  -1,  -1,  -1,  -1,  -1,  -1,  -1,  -1,  -1, -1,  -1,
         -1,  -1,  -1,  -1,  -1,  -1,  -1,   -1,  -1,  -1,  -1,  -1,  -1,  -1,  -1,  -1,  -1,  -1,  -1,  -1,  -1,  -1,  -1,  -1,  -1,  -1,  -1,  -1, -1,  -1,
         -1,  -1,  -1,  -1,  -1,  -1,  -1,   -1,  -1,  -1,  -1,  -1,  -1,  -1,  -1,  -1,  -1,  -1,  -1,  -1,  -1,  -1,  -1,  -1,  -1,  -1,  -1,  -1, -1,  -1,
         -1,  -1,  -1,  -1,  -1,  -1,  -1,   -1,  -1,  -1,  -1,  -1,  -1,  -1,  -1,  -1,  -1,  -1,  -1,  -1,  -1,  -1,  -1,  -1,  -1,  -1,  -1,  -1, -1,  -1,
         -1,  -1,  -1,  -1,  -1,  -1,  -1,   -1,  -1,  -1,  -1,  -1,  -1,  -1,  -1,  -1,  -1,  -1,  -1,  -1,  -1,  -1,  -1,  -1,  -1,  -1,  -1,  -1, -1,  -1,
         -1,  -1,  -1,  -1,  -1,  -1,  -1,   -1,  -1,  -1,  -1,  -1,  -1,  -1,  -1,  -1,  -1,  -1,  -1,  65,  -1,  -1,  -1,  -1,  -1,  -1,  65,  -1, -1,  -1,
         -1,  -1,  -1,  -1,  -1,  -1,  -1,   -1,  -1,  -1,  -1,  -1,  -1,  -1,  -1,  -1,  -1,  -1,  -1, 123,  -1,  -1,  -1,  -1,  -1,  -1, 123,  -1, -1,  -1,
         -1,  -1,  -1,  -1,  -1,  -1,  -1,   -1,  -1,  -1,  -1,  -1,  -1,  -1,  -1,  -1,  -1,  -1,  -1,  -1,  -1,  -1,  -1,  -1,  -1,  -1,  -1,  -1, -1,  -1,
         -1,  -1,  -1,  -1,  -1,  -1,  -1,   -1,  -1,  -1,  -1,  -1,  -1,  -1,  -1,  -1,  -1,  -1,  -1,  -1,  -1,  -1,  -1,  -1,  -1,  -1,  -1,  -1, -1,  -1,
         -1,  -1,  -1,  -1,  -1,  -1,  -1,   -1,  -1,  -1,  -1,  -1,  -1,  -1,  -1,  -1,  -1,  -1,  -1,  -1,  -1,  -1,  -1,  -1,  -1,  -1,  -1,  -1, -1,  -1,
         -1,  -1,  -1,  -1,  -1,  -1,  -1,   -1,  -1,  -1,  -1,  -1,  -1,  -1,  -1,  -1,  -1,  -1,  -1,  -1,  -1,  -1,  -1,  -1,  -1,  -1,  -1,  -1, -1,  -1,
        872, 873, 872, 873, 872, 873, 872, 873, 872, 873, 872, 873, 872,  -1,  -1,  -1,  -1, 873, 872, 873, 872, 878,  -1,  -1, 881, 873, 872, 873, 872, 873,
        872, 873, 872, 873, 872, 873, 872, 873, 872, 873, 872, 873, 872,   -1,  -1,  -1,  -1, 873, 872, 873, 872, 878, 873, 872, 881, 873, 872, 873, 872, 873
      ],
      "tileset": "dungeon"
    },
    "lightWalls": {
      "tiles": [

        698,   2,   3,   1,   2,   3,   1,   2,   3,   1,   2,   3,   1,   1,   2,   3,   1,   3,   1,   2,   3,   2,   3,   1,   2,   3,   3,   1,   2, 699,
        756, 873, 873, 117, 120, 118, 120, 175, 120, 176, 120, 873, 872,  -1,  -1,  -1,  -1, 873, 872, 873, 873, 872, 873, 873, 872, 872, 872, 873, 872, 757,
        755,  -1,  -1,  -1,  -1,  -1,  -1,  -1,  -1,  -1,  -1,  -1,  -1,  -1,  -1,  -1,  -1,  -1,  -1,  -1,  -1,  -1,  -1,  -1,  -1,  -1,  -1,  -1,  -1, 754,
        755,  -1,  -1,  -1,  -1,  -1,  -1,  -1,  -1,  -1,  -1,  -1,  -1,  -1,  -1,  -1,  -1,  -1,  -1,  -1,  -1,  -1,  -1,  -1,  -1,  -1,  -1,  -1,  -1, 754,
        755,  -1,  -1,  -1,  -1,  -1,  -1,  -1,  -1,  -1,  -1,  -1,  -1,  -1,  -1,  -1,  -1,  -1,  -1,  -1,  -1,  -1,  -1,  -1,  -1,  -1,  -1,  -1,  -1, 754,
        755,  -1,  -1,  -1,  -1,  -1,  -1,  -1,  -1,  -1,  -1,  -1,  -1,  -1,  -1,  -1,  -1,  -1,  -1,  -1,  -1,  -1,  -1,  -1,  -1,  -1,  -1,  -1,  -1, 754,
        755,  -1,  -1,  -1,  -1,  -1,  -1,  -1,  -1,  -1,  -1,  -1, 696,   1,   2,   3,   1, 697,  -1,  -1,  -1,  -1,  -1,  -1,  -1,  -1,  -1,  -1,  -1, 754,
        755,  -1,  -1,  -1,  -1,  -1,  -1,  -1,  -1,  -1,  -1,  -1, 754,  -1,  -1,  -1,  -1, 755,  -1,  -1,  -1,  -1,  -1,  -1,  -1,  -1,  -1,  -1,  -1, 754,
        755,  -1,  -1,  -1,  -1,  -1,  -1,  -1,  -1,  -1,  -1,  -1, 754,  -1,  -1,  -1,  -1, 755,  -1,  -1,  -1,  -1,  -1,  -1,  -1,  -1,  -1,  -1,  -1, 754,
        755,  -1,  -1,  -1,  -1,  -1,  -1,  -1,  -1,  -1,  -1,  -1, 754,  -1,  -1,  -1,  -1, 755,  -1,  -1,  -1,  -1,  -1,  -1,  -1,  -1,  -1,  -1,  -1, 754,
        755,  -1,  -1,  -1,  -1,  -1,  -1,  -1,  -1,  -1,  -1,  -1, 754,  -1,  -1,  -1,  -1, 755,  -1,  -1,  -1,  -1,  -1,  -1,  -1,  -1,  -1,  -1,  -1, 754,
        755,  -1,  -1,  -1,  -1,  -1,  -1,  -1,  -1,  -1,  -1,  -1, 754,  -1,  -1,  -1,  -1, 755,  -1,  -1,  -1,  -1,  -1,  -1,  -1,  -1,  -1,  -1,  -1, 754,
        755,  -1,  -1,  -1,  -1,  -1,  -1,  -1,  -1,  -1,  -1,  -1, 754,  -1,  -1,  -1,  -1, 755,  -1,  -1,  -1,  -1,  -1,  -1,  -1,  -1,  -1,  -1,  -1, 754,
        755,  -1,  -1,  -1,  -1,  -1,  -1,  -1,  -1,  -1,  -1,  -1, 754,  -1,  -1,  -1,  -1, 755,  -1,   7,  -1,  -1,  -1,  -1,  -1,  -1,   7,  -1,  -1, 754,
        755,  -1,  -1,  -1,  -1,  -1,  -1,  -1,  -1,  -1,  -1,  -1, 754,  -1,  -1,  -1,  -1, 755,  -1,  -1,  -1,  -1,  -1,  -1,  -1,  -1,  -1,  -1,  -1, 754,
        755,  -1,  -1,  -1,  -1,  -1,  -1,  -1,  -1,  -1,  -1,  -1, 754,  -1,  -1,  -1,  -1, 755,  -1,  -1,  -1,  -1,  -1,  -1,  -1,  -1,  -1,  -1,  -1, 754,
        755,  -1,  -1,  -1,  -1,  -1,  -1,  -1,  -1,  -1,  -1,  -1, 754,  -1,  -1,  -1,  -1, 755,  -1,  -1,  -1,  -1,  -1,  -1,  -1,  -1,  -1,  -1,  -1, 754,
        755,  -1,  -1,  -1,  -1,  -1,  -1,  -1,  -1,  -1,  -1,  -1, 754,  -1,  -1,  -1,  -1, 755,  -1,  -1,  -1,  -1,  -1,  -1,  -1,  -1,  -1,  -1,  -1, 754,
        755,  -1,  -1,  -1,  -1,  -1,  -1,  -1,  -1,  -1,  -1,  -1, 754,  -1,  -1,  -1,  -1, 755,  -1,  -1,  -1,  -1, 763, 764,  -1,  -1,  -1,  -1,  -1, 754,
        814,   2,   3,   1,   2,   3,   1,   2,   3,   1,   2,   3, 758,  -1,  -1,  -1,  -1, 759,   1,   2,   3, 820,  -1,  -1, 823,   2,   3,   1,   2, 815,
        872, 873, 872, 873, 872, 873, 872, 873, 872, 873, 872, 873, 872,  -1,  -1,  -1,  -1, 872, 872, 873, 872,  -1,  -1,  -1,  -1, 873, 872, 873, 872, 873,
         -1,  -1,  -1,  -1,  -1,  -1,  -1,  -1,  -1,  -1,  -1,  -1,  -1,  -1,  -1,  -1,  -1,  -1,  -1,  -1,  -1,  -1,  -1,  -1,  -1,  -1,  -1,  -1,  -1,  -1
      ],
      "tileset": "dungeon"
    },
    "decorations": {
      "tiles": [
        -1,  -1,  -1,  -1,  -1,  -1,  -1,  -1,  -1,  -1,  -1,  -1,  -1, 236, 236, 236, 236,  -1,  -1,  -1,  -1, 236,  -1,  -1, 236,  -1,  -1,  -1,  -1,  -1,
        -1,1458,  -1,  -1,  -1,  -1,  -1,  -1,  -1,  -1,  -1,  -1,  -1, 410, 410, 410, 410,  -1,  -1,  -1,  -1, 294,  -1,  -1, 294,  -1,  -1,  -1,1458,  -1,
        -1,1516,  -1,  -1,  -1,  -1,  -1,  -1,  -1,  -1,  -1,  -1,  -1, 468, 468, 468, 468,  -1,  -1,  -1,  -1, 352,  -1,  -1, 352,  -1,  -1,  -1,1516,  -1,
        -1,  -1,  -1,  -1,  -1,  -1,  -1,  -1,  -1,  -1,  -1,  -1,  -1,  -1,  -1,  -1,  -1,  -1,  -1,  -1,  -1,  -1,  -1,  -1,  -1,  -1,  -1,  -1,  -1,  -1,
        -1,  -1,  -1,  -1,  -1,  -1,  -1,  -1,  -1,  -1,  -1,  -1,  -1,  -1,  -1,  -1,  -1,  -1,  -1,  -1,  -1,  -1,  -1,  -1,  -1,  -1,  -1,  -1,  -1,  -1,
        -1,  -1,  -1,  -1,  -1,  -1,  -1,  -1,  -1,  -1,  -1,  -1,1458,  -1,  -1,  -1,  -1,1458,  -1,  -1,  -1,  -1,  -1,  -1,  -1,  -1,  -1,  -1,  -1,  -1,
        -1,  -1,  -1,  -1,  -1,  -1,  -1,  -1,  -1,  -1,  -1,  -1,1516,  -1,  -1,  -1,  -1,1516,  -1,  -1,  -1,  -1,  -1,  -1,  -1,  -1,  -1,  -1,  -1,  -1,
        -1,  -1,  -1,  -1,  -1,  -1,  -1,  -1,  -1,  -1,  -1,  -1,  -1,  -1,  -1,  -1,  -1,  -1,  -1,  -1,  -1,  -1,  -1,  -1,  -1,  -1,  -1,  -1,  -1,  -1,
        -1,  -1,  -1,  -1,  -1,  -1,  -1,  -1,  -1,  -1,  -1,  -1,  -1,  -1,  -1,  -1,  -1,  -1,  -1,  -1,  -1,  -1,  -1,  -1,  -1,  -1,  -1,  -1,  -1,  -1,
        -1,  -1,  -1,  -1,  -1,  -1,  -1,  -1,  -1,  -1,  -1,  -1,  -1,  -1,  -1,  -1,  -1,  -1,  -1,  -1,  -1,  -1,  -1,  -1,  -1,  -1,  -1,  -1,  -1,  -1,
        -1,  -1,  -1,  -1,  -1,  -1,  -1,  -1,  -1,  -1,  -1,  -1,  -1,  -1,  -1,  -1,  -1,  -1,  -1,  -1,  -1,  -1,  -1,  -1,  -1,  -1,  -1,  -1,  -1,  -1,
        -1,  -1,  -1,  -1,  -1,  -1,  -1,  -1,  -1,  -1,  -1,  -1,  -1,  -1,  -1,  -1,  -1,  -1,  -1,  -1,  -1,  -1,  -1,  -1,  -1,  -1,  -1,  -1,  -1,  -1,
        -1,  -1,  -1,  -1,  -1,  -1,  -1,  -1,  -1,  -1,  -1,  -1,  -1,  -1,  -1,  -1,  -1,  -1,  -1,  -1,  -1,  -1,  -1,  -1,  -1,  -1,  -1,  -1,  -1,  -1,
        -1,  -1,  -1,  -1,  -1,  -1,  -1,  -1,  -1,  -1,  -1,  -1,  -1,  -1,  -1,  -1,  -1,  -1,  -1,  -1,  -1,  -1,  -1,  -1,  -1,  -1,  -1,  -1,  -1,  -1,
        -1,  -1,  -1,  -1,  -1,  -1,  -1,  -1,  -1,  -1,  -1,  -1,  -1,  -1,  -1,  -1,  -1,  -1,  -1,  -1,  -1,  -1,  -1,  -1,  -1,  -1,  -1,  -1,  -1,  -1,
        -1,  -1,  -1,  -1,  -1,  -1,  -1,  -1,  -1,  -1,  -1,  -1,  -1,  -1,  -1,  -1,  -1,  -1,  -1,  -1,  -1,  -1,  -1,  -1,  -1,  -1,  -1,  -1,  -1,  -1,
        -1,  -1,  -1,  -1,  -1,  -1,  -1,  -1,  -1,  -1,  -1,  -1,  -1,  -1,  -1,  -1,  -1,  -1,  -1,  -1,  -1,  -1,  -1,  -1,  -1,  -1,  -1,  -1,  -1,  -1,
        -1,  -1,  -1,  -1,  -1,  -1,  -1,  -1,  -1,  -1,  -1,  -1,  -1,  -1,  -1,  -1,  -1,  -1,  -1,  -1,  -1,  -1,  -1,  -1,  -1,  -1,  -1,  -1,  -1,  -1,
        -1,1458,  -1,  -1,  -1,  -1,  -1,  -1,  -1,  -1,  -1,1458,  -1,  -1,  -1,  -1,  -1,  -1,1458,  -1,  -1,  -1,  -1,  -1,  -1,  -1,  -1,  -1,1458,  -1,
        -1,1516,  -1,  -1,  -1,  -1,  -1,  -1,  -1,  -1,  -1,1516,  -1,  -1,  -1,  -1,  -1,  -1,1516,  -1,  -1,  -1,  -1,  -1,  -1,  -1,  -1,  -1,1516,  -1,
        -1,  -1,  -1,  -1,  -1,  -1,  -1,  -1,  -1,  -1,  -1,  -1,  -1,  -1,  -1,  -1,  -1,  -1,  -1,  -1,  -1,  -1,  -1,  -1,  -1,  -1,  -1,  -1,  -1,  -1,
        -1,  -1,  -1,  -1,  -1,  -1,  -1,  -1,  -1,  -1,  -1,  -1,  -1,  -1,  -1,  -1,  -1,  -1,  -1,  -1,  -1,  -1,  -1,  -1,  -1,  -1,  -1,  -1,  -1,  -1
      ],
      "tileset": "dungeon"
    }
  }
}
