{
  "tileLayers": {
    "floor": {
      "tiles": [
        408, 408, 408, 408, 408, 408, 408, 408, 408, 408, 408, 408, 408, 408, 408, 408, 408, 408, 408, 408, 408, 408, 408, 408, 408, 408, 408, 408, 408, 408,
        408, 408, 408, 408, 408, 408, 408, 408, 408, 408, 408, 408, 408, 408, 408, 408, 408, 408, 408, 408, 408, 408, 408,  299,  300, 408, 408, 408, 408, 408,
        241, 233, 235, 291, 233, 235, 241, 293, 350, 234, 409, 241, 408, 408, 408, 408, 408, 408, 242, 409, 233, 350, 408,  233,  233, 291, 349, 291, 350, 233,
        241, 934, 235, 291, 233, 235, 241, 293, 350, 234, 409, 241, 408, 408, 408, 408, 408, 408, 242, 409, 233, 350, 233, 350, 409, 291, 349, 291, 350, 233,
        241, 350, 409, 241, 292, 233, 235, 242, 293, 350, 234, 233, 408, 408, 408, 408, 408, 408, 409, 241, 292, 233, 235, 242, 293, 350, 234, 233, 349, 233,
        241, 242, 234, 349, 293, 242, 242, 233, 409, 235, 234, 241, 408, 408, 408, 408, 408, 408, 234, 349, 409, 246, 244, 244, 244, 244, 245, 234, 241, 233,
        241, 233, 235, 291, 233, 235, 241, 293, 350, 234, 409, 241, 408, 408, 408, 408, 408, 408, 300, 300, 241, 304, 302, 305, 302, 302, 306, 242, 300, 300,
        241, 233, 234, 235, 241, 242, 233, 234, 235, 241, 242, 234, 408, 408, 408, 408, 408, 408, 300, 300, 242, 304, 302, 302, 302, 302, 306, 241, 300, 300,
        241, 242, 234, 349, 293, 242, 242, 233, 409, 235, 234, 241, 408, 408, 408, 408, 408, 408, 300, 300, 300, 304, 302, 302, 305, 305, 306, 300, 300, 300,
        241, 350, 409, 241, 292, 233, 235, 242, 293, 350, 234, 233, 408, 408, 408, 408, 408, 408, 300, 300, 300, 304, 305, 302, 302, 302, 306, 300, 300, 300,
        241, 233, 234, 235, 241, 242, 233, 234, 235, 241, 242, 234, 408, 408, 408, 408, 408, 408, 300, 300, 300, 304, 302, 305, 302, 302, 306, 300, 300, 300,
        241, 242, 234, 349, 293, 242, 242, 233, 409, 235, 234, 241, 408, 408, 408, 408, 408, 408, 409, 350, 292, 420, 421, 418, 421, 421, 422, 234, 241, 233,
        241, 233, 234, 235, 241, 242, 233, 234, 235, 241, 242, 234, 408, 408, 408, 408, 408, 408, 234, 235, 233, 242, 233, 234, 235, 241, 242, 234, 235, 241,
        241, 350, 409, 241, 292, 233, 235, 242, 293, 350, 234, 233, 408, 408, 408, 408, 408, 408, 409, 241, 292, 233, 235, 242, 293, 350, 234, 233, 349, 241,
        241, 233, 235, 291, 233, 235, 241, 293, 350, 234, 409, 241, 408, 408, 408, 408, 408, 408, 242, 409, 233, 350, 233, 350, 409, 291, 349, 291, 350, 241,
        241, 242, 234, 349, 293, 242, 242, 233, 409, 235, 234, 241, 408, 408, 408, 408, 408, 408, 234, 349, 293, 242, 242, 233, 235, 235, 409, 241, 233, 241,
        241, 233, 235, 291, 233, 235, 241, 293, 350, 234, 409, 241, 408, 408, 408, 408, 408, 408, 242, 409, 233, 350, 233, 350, 234, 291, 349, 291, 350, 241,
        241, 242, 234, 349, 293, 242, 242, 233, 409, 235, 234, 241, 408, 408, 408, 408, 408, 408, 234, 349, 293, 242, 242, 233, 409, 235, 234, 241, 409, 241,
        241, 350, 409, 241, 292, 233, 235, 242, 293, 350, 234, 233, 408, 408, 408, 408, 408, 408, 409, 241, 292, 233, 235, 242, 293, 350, 234, 233, 349, 241,
        241, 233, 235, 291, 233, 235, 241, 293, 350, 234, 409, 241, 408, 408, 408, 408, 408, 408, 242, 409, 233, 350, 233, 350, 409, 291, 349, 291, 350, 241,
        408, 408, 408, 408, 408, 408, 408, 408, 408, 408, 408, 408, 408, 408, 408, 408, 408, 408, 408, 408, 408, 408, 408, 408, 408, 408, 408, 408, 408, 408,
        408, 408, 408, 408, 408, 408, 408, 408, 408, 408, 408, 408, 408, 408, 408, 408, 408, 408, 408, 408, 408, 408, 408, 408, 408, 408, 408, 408, 408, 408
      ],
      "tileset": "dungeon"
    },
    "darkWalls": {
      "tiles": [
         -1,  -1,  -1,  -1,  -1,  -1,  -1,  -1,  -1,  -1,  -1,  -1,  -1,  -1,  -1,  -1,  -1,  -1,  -1,  -1,  -1,  -1,  -1,  -1,  -1,  -1,  -1,  -1,  -1,  -1,
         -1,  -1,  -1,  -1,  -1,  -1,  -1,  -1,  -1,  -1,  -1,  -1,  -1,  -1,  -1,  -1,  -1,  -1,  -1,  -1,  -1,  -1,  -1,  -1,  -1,  -1,  -1,  -1,  -1,  -1,
         -1, 873, 117, 120, 118, 120, 175, 120, 176, 120, 873, 873,  -1,  -1,  -1,  -1,  -1,  -1, 872, 873, 873, 119, 878,  -1,  -1, 881, 119, 873, 872, 757,
         -1,  -1,  -1,  -1,  -1,  -1,  -1,  -1,  -1,  -1,  -1,  -1,  -1,  -1,  -1,  -1,  -1,  -1,  -1,  -1,  -1,  -1,  -1,  -1,  -1,  -1,  -1,  -1,  -1, 754,
         -1,  -1,  -1,  -1,  -1,  -1,  -1,  -1,  -1,  -1,  -1,  -1,  -1,  -1,  -1,  -1,  -1,  -1,  -1,  -1,  -1,  -1,  -1,  -1,  -1,  -1,  -1,  -1,  -1, 754,
         -1,  -1,  -1,  -1,  -1,  -1,  -1,  -1,  -1,  -1,  -1,  -1,  -1,  -1,  -1,  -1,  -1,  -1,  -1,  -1,  -1,  -1,  -1,  -1,  -1,  -1,  -1,  -1,  -1, 754,
         -1,  -1,  -1,  -1,  -1,  -1,  -1,  -1,  -1,  -1,  -1,  -1,  -1,  -1,  -1,  -1,  -1,  -1,  -1,  -1,  -1,  -1,  -1,  -1,  -1,  -1,  -1,  -1,  -1, 754,
         -1,  -1,  -1,  -1,  -1,  -1,  -1,  -1,  -1,  -1,  -1,  -1,  -1,  -1,  -1,  -1,  -1,  -1,  -1,  -1,  -1,  -1,  -1,  -1,  -1,  -1,  -1,  -1,  -1, 754,
         -1,  -1,  -1,  -1,  -1,  -1,  -1,  -1,  -1,  -1,  -1,  -1,  -1,  -1,  -1,  -1,  -1,  -1,  -1,  -1,  -1,  -1,  -1,  -1,  -1,  -1,  -1,  -1,  -1, 754,
         -1,  -1,  -1,  -1,  -1,  -1,  -1,  -1,  -1,  -1,  -1,  -1,  -1,  -1,  -1,  -1,  -1,  -1,  -1,  -1,  -1,  -1,  -1,  -1,  -1,  -1,  -1,  -1,  -1, 754,
         -1,  -1,  -1,  -1,  -1,  -1,  -1,  -1,  -1,  -1,  -1,  -1,  -1,  -1,  -1,  -1,  -1,  -1,  -1,  -1,  -1,  -1,  -1,  -1,  -1,  -1,  -1,  -1,  -1, 754,
         -1,  -1,  -1,  -1,  -1,  -1,  -1,  -1,  -1,  -1,  -1,  -1,  -1,  -1,  -1,  -1,  -1,  -1,  -1,  -1,  -1,  -1,  -1,  -1,  -1,  -1,  -1,  -1,  -1, 754,
         -1,  -1,  -1,  -1,  -1,  -1,  -1,  -1,  -1,  -1,  -1,  -1,  -1,  -1,  -1,  -1,  -1,  -1,  -1,  -1,  -1,  -1,  -1,  -1,  -1,  -1,  -1,  -1,  -1, 754,
         -1,  -1,  -1,  -1,  -1,  -1,  -1,  -1,  -1,  -1,  -1,  -1,  -1,  -1,  -1,  -1,  -1,  -1,  -1,  -1,  -1,  -1,  -1,  -1,  -1,  -1,  -1,  -1,  -1, 754,
         -1,  -1,  -1,  -1,  -1,  -1,  -1,  -1,  -1,  -1,  -1,  -1,  -1,  -1,  -1,  -1,  -1,  -1,  -1,  -1,  -1,  -1,  -1,  -1,  -1,  -1,  -1,  -1,  -1, 754,
         -1,  -1,  -1,  -1,  -1,  -1,  -1,  -1,  -1,  -1,  -1,  -1,  -1,  -1,  -1,  -1,  -1,  -1,  -1,  -1,  -1,  -1,  -1,  -1,  -1,  -1,  -1,  -1,  -1, 754,
         -1,  -1,  -1,  -1,  -1,  -1,  -1,  -1,  -1,  -1,  -1,  -1,  -1,  -1,  -1,  -1,  -1,  -1,  -1,  -1,  -1,  -1,  -1,  -1,  -1,  -1,  -1,  -1,  -1, 754,
         -1,  -1,  -1,  -1,  -1,  -1,  -1,  -1,  -1,  -1,  -1,  -1,  -1,  -1,  -1,  -1,  -1,  -1,  -1,  -1,  -1,  -1,  -1,  -1,  -1,  -1,  -1,  -1,  -1, 754,
         -1,  -1,  -1,  -1,  -1,  -1,  -1,  -1,  -1,  -1,  -1,  -1,  -1,  -1,  -1,  -1,  -1,  -1,  -1,  -1,  -1,  -1,  -1,  -1,  -1,  -1,  -1,  -1,  -1, 754,
         -1,   2,   3,   1,   2,   3,   1,   2,   3,   1,   2,   3,  -1,  -1,  -1,  -1,  -1,  -1,   1,   2,   3,   1,   2,   3,   1,   2,   3,   1,   2, 758,
        872, 873, 872, 873, 872, 873, 872, 873, 872, 873, 872, 873,  -1,  -1,  -1,  -1,  -1,  -1, 872, 873, 872, 873, 872, 873, 872, 873, 872, 873, 872, 873,
        872, 873, 872, 873, 872, 873, 872, 873, 872, 873, 872, 873,  -1,  -1,  -1,  -1,  -1,  -1, 872, 873, 872, 873, 872, 873, 872, 873, 872, 873, 872, 873
      ],
      "tileset": "dungeon"
    },
    "lightWalls": {
      "tiles": [
         -1,  -1,  -1,  -1,  -1,  -1,  -1,  -1,  -1,  -1,  -1,  -1,  -1,  -1,  -1,  -1,  -1,  -1,  -1,  -1,  -1,  -1,  -1, 763, 764,  -1,  -1,  -1,  -1,  -1,
        698, 875, 875, 875, 875, 875, 875, 875, 875, 875, 875, 699,  -1,  -1,  -1,  -1,  -1,  -1, 698, 875, 875, 875, 820,  -1,  -1, 823, 875, 875, 875, 699,
        756,  -1,  -1,  -1,  -1,  -1,  -1,  -1,  -1,  -1,  -1, 816,  -1,  -1,  -1,  -1,  -1,  -1, 817,  -1,  -1,  -1,  -1,  -1,  -1,  -1,  -1,  -1,  -1, 757,
        755,  -1,  -1,  -1,  -1,  -1,  -1,  -1,  -1,  -1,  -1, 754,  -1,  -1,  -1,  -1,  -1,  -1, 755,  -1,  -1,  -1,  -1,  -1,  -1,  -1,  -1,  -1,  -1, 754,
        755,  -1,  -1,  -1,  -1,  -1,  -1,  -1,  -1,  -1,  -1, 754,  -1,  -1,  -1,  -1,  -1,  -1, 755,  -1,  -1,  -1,  -1,  -1,  -1,  -1,  -1,  -1,  -1, 754,
        755,  -1,  -1,  -1,  -1,  -1,  -1,  -1,  -1,  -1,  -1, 754,  -1,  -1,  -1,  -1,  -1,  -1, 755,  -1,   7,  -1,  -1,  -1,  -1,  -1,  -1,   7,  -1, 754,
        755,  -1,  -1,  -1,  -1,  -1,  -1,  -1,  -1,  -1,  -1, 754,  -1,  -1,  -1,  -1,  -1,  -1, 755,  -1,  65,  -1,  -1,  -1,  -1,  -1,  -1,  65,  -1, 754,
        755,  -1,  -1,  -1,  -1,  -1,  -1,  -1,  -1,  -1,  -1, 754,  -1,  -1,  -1,  -1,  -1,  -1, 755,  -1, 123,  -1,  -1,  -1,  -1,  -1,  -1, 123,  -1, 754,
        755,  -1,  -1,  -1,  -1,  -1,  -1,  -1,  -1,  -1,  -1, 754,  -1,  -1,  -1,  -1,  -1,  -1, 755,  -1,  -1,  -1,  -1,  -1,  -1,  -1,  -1,  -1,  -1, 754,
        755,  -1,  -1,  -1,  -1,  -1,  -1,  -1,  -1,  -1,  -1, 754,  -1,  -1,  -1,  -1,  -1,  -1, 755,  -1,  -1,  -1,  -1,  -1,  -1,  -1,  -1,  -1,  -1, 754,
        755,  -1,  -1,  -1,  -1,  -1,  -1,  -1,  -1,  -1,  -1, 754,  -1,  -1,  -1,  -1,  -1,  -1, 755,  -1,  -1,  -1,  -1,  -1,  -1,  -1,  -1,  -1,  -1, 754,
        755,  -1,  -1,  -1,  -1,  -1,  -1,  -1,  -1,  -1,  -1, 754,  -1,  -1,  -1,  -1,  -1,  -1, 755,  -1,  -1,  -1,  -1,  -1,  -1,  -1,  -1,  -1,  -1, 754,
        755,  -1,  -1,  -1,  -1,  -1,  -1,  -1,  -1,  -1,  -1, 754,  -1,  -1,  -1,  -1,  -1,  -1, 755,  -1,  -1,  -1,  -1,  -1,  -1,  -1,  -1,  -1,  -1, 754,
        755,  -1,  -1,  -1,  -1,  -1,  -1,  -1,  -1,  -1,  -1, 754,  -1,  -1,  -1,  -1,  -1,  -1, 755,  -1,  -1,  -1,  -1,  -1,  -1,  -1,  -1,  -1,  -1, 754,
        755,  -1,  -1,  -1,  -1,  -1,  -1,  -1,  -1,  -1,  -1, 754,  -1,  -1,  -1,  -1,  -1,  -1, 755,  -1,  -1,  -1,  -1,  -1,  -1,  -1,  -1,  -1,  -1, 754,
        755,  -1,  -1,  -1,  -1,  -1,  -1,  -1,  -1,  -1,  -1, 754,  -1,  -1,  -1,  -1,  -1,  -1, 755,  -1,  -1,  -1,  -1,  -1,  -1,  -1,  -1,  -1,  -1, 754,
        755,  -1,  -1,  -1,  -1,  -1,  -1,  -1,  -1,  -1,  -1, 754,  -1,  -1,  -1,  -1,  -1,  -1, 755,  -1,  -1,  -1,  -1,  -1,  -1,  -1,  -1,  -1,  -1, 754,
        755,  -1,  -1,  -1,  -1,  -1,  -1,  -1,  -1,  -1,  -1, 754,  -1,  -1,  -1,  -1,  -1,  -1, 755,  -1,  -1,  -1,  -1,  -1,  -1,  -1,  -1,  -1,  -1, 754,
        755,  -1,  -1,  -1,  -1,  -1,  -1,  -1,  -1,  -1,  -1, 754,  -1,  -1,  -1,  -1,  -1,  -1, 755,  -1,  -1,  -1,  -1,  -1,  -1,  -1,  -1,  -1,  -1, 754,
        759,   2,   3,   1,   2,   3,   1,   2,   3,   1,   2, 758,  -1,  -1,  -1,  -1,  -1,  -1, 759,   2,   3,   1,   2,   3,   1,   2,   3,   1,   2, 758,
         -1,  -1,  -1,  -1,  -1,  -1,  -1,  -1,  -1,  -1,  -1,  -1,  -1,  -1,  -1,  -1,  -1,  -1,  -1,  -1,  -1,  -1,  -1,  -1,  -1,  -1,  -1,  -1,  -1,  -1,
         -1,  -1,  -1,  -1,  -1,  -1,  -1,  -1,  -1,  -1,  -1,  -1,  -1,  -1,  -1,  -1,  -1,  -1,  -1,  -1,  -1,  -1,  -1,  -1,  -1,  -1,  -1,  -1,  -1,  -1
      ],
      "tileset": "dungeon"
    },
    "decorations": {
      "tiles": [
        -1,  -1,  -1,  -1,  -1,  -1,  -1,   -1,  -1,  -1,  -1,  -1,  -1,  -1,  -1,  -1,  -1,  -1,  -1,  -1,  -1,  -1,  -1,  -1,  -1,  -1,  -1,  -1,  -1,  -1,
        -1,  -1,  -1,  -1,  -1,  -1,  -1,   -1,  -1,  -1,  -1,  -1,  -1,  -1,  -1,  -1,  -1,  -1,  -1,  -1,  -1,  -1, 236,  -1,  -1, 236,  -1,  -1,  -1,  -1,
        -1, -1,  -1,  1458,  -1,  -1,  -1,   -1,  -1,  -1,1458,  -1,  -1,  -1,  -1,  -1,  -1,  -1,  -1,1458,  -1,  -1, 294,  -1,  -1, 294,  -1,  -1,1458,  -1,
        -1, -1,  -1,  1516,  -1,  -1,  -1,   -1,  -1,  -1,1516,  -1,  -1,  -1,  -1,  -1,  -1,  -1,  -1,1516,  -1,  -1, 352,  -1,  -1, 352,  -1,  -1,1516,  -1,
        -1,  -1,  -1,  -1,  -1,  -1,  -1,   -1,  -1,  -1,  -1,  -1,  -1,  -1,  -1,  -1,  -1,  -1,  -1,  -1,  -1,  -1,  -1,  -1,  -1,  -1,  -1,  -1,  -1,  -1,
        -1,  -1,  -1,  -1,  -1,  -1,  -1,   -1,  -1,  -1,  -1,  -1,  -1,  -1,  -1,  -1,  -1,  -1,  -1,  -1,  -1,  -1,  -1,  -1,  -1,  -1,  -1,  -1,  -1,  -1,
        -1,  -1,  -1,  -1,  -1,  -1,  -1,   -1,  -1,  -1,  -1,  -1,  -1,  -1,  -1,  -1,  -1,  -1,  -1,  -1,  -1,  -1,  -1,  -1,  -1,  -1,  -1,  -1,  -1,  -1,
        -1,  -1,  -1,  -1,  -1,  -1,  -1,   -1,  -1,  -1,  -1,  -1,  -1,  -1,  -1,  -1,  -1,  -1,  -1,  -1,  -1,  -1,  -1,  -1,  -1,  -1,  -1,  -1,  -1,  -1,
        -1,  -1,  -1,  -1,  -1,  -1,  -1,   -1,  -1,  -1,  -1,  -1,  -1,  -1,  -1,  -1,  -1,  -1,  -1,  -1,  -1,  -1,  -1,  -1,  -1,  -1,  -1,  -1,  -1,  -1,
        -1,  -1,  -1,  -1,  -1,  -1,  -1,   -1,  -1,  -1,  -1,  -1,  -1,  -1,  -1,  -1,  -1,  -1,  -1,  -1,  -1,  -1,  -1,  -1,  -1,  -1,  -1,  -1,  -1,  -1,
        -1,  -1,  -1,  -1,  -1,  -1,  -1,   -1,  -1,  -1,  -1,  -1,  -1,  -1,  -1,  -1,  -1,  -1,  -1,  -1,  -1,  -1,  -1,  -1,  -1,  -1,  -1,  -1,  -1,  -1,
        -1,  -1,  -1,  -1,  -1,  -1,  -1,   -1,  -1,  -1,  -1,  -1,  -1,  -1,  -1,  -1,  -1,  -1,  -1,  -1,  -1,  -1,  -1,  -1,  -1,  -1,  -1,  -1,  -1,  -1,
        -1,  -1,  -1,  -1,  -1,  -1,  -1,   -1,  -1,  -1,  -1,  -1,  -1,  -1,  -1,  -1,  -1,  -1,  -1,  -1,  -1,  -1,  -1,  -1,  -1,  -1,  -1,  -1,  -1,  -1,
        -1,  -1,  -1,  -1,  -1,  -1,  -1,   -1,  -1,  -1,  -1,  -1,  -1,  -1,  -1,  -1,  -1,  -1,  -1,  -1,  -1,  -1,  -1,  -1,  -1,  -1,  -1,  -1,  -1,  -1,
        -1,  -1,  -1,  -1,  -1,  -1,  -1,   -1,  -1,  -1,  -1,  -1,  -1,  -1,  -1,  -1,  -1,  -1,  -1,  -1,  -1,  -1,  -1,  -1,  -1,  -1,  -1,  -1,  -1,  -1,
        -1,  -1,  -1,  -1,  -1,  -1,  -1,   -1,  -1,  -1,  -1,  -1,  -1,  -1,  -1,  -1,  -1,  -1,  -1,  -1,  -1,  -1,  -1,  -1,  -1,  -1,  -1,  -1,  -1,  -1,
        -1,  -1,  -1,  -1,  -1,  -1,  -1,   -1,  -1,  -1,  -1,  -1,  -1,  -1,  -1,  -1,  -1,  -1,  -1,  -1,  -1,  -1,  -1,  -1,  -1,  -1,  -1,  -1,  -1,  -1,
        -1,  -1,  -1,  -1,  -1,  -1,  -1,   -1,  -1,  -1,  -1,  -1,  -1,  -1,  -1,  -1,  -1,  -1,  -1,  -1,  -1,  -1,  -1,  -1,  -1,  -1,  -1,  -1,  -1,  -1,
        -1,1458,  -1,  -1,  -1,  -1,  -1,   -1,  -1,  -1,1458,  -1,  -1,  -1,  -1,  -1,  -1,  -1,  -1,1458,  -1,  -1,  -1,  -1,  -1,  -1,  -1,  -1,1458,  -1,
        -1,1516,  -1,  -1,  -1,  -1,  -1,   -1,  -1,  -1,1516,  -1,  -1,  -1,  -1,  -1,  -1,  -1,  -1,1516,  -1,  -1,  -1,  -1,  -1,  -1,  -1,  -1,1516,  -1,
        -1,  -1,  -1,  -1,  -1,  -1,  -1,   -1,  -1,  -1,  -1,  -1,  -1,  -1,  -1,  -1,  -1,  -1,  -1,  -1,  -1,  -1,  -1,  -1,  -1,  -1,  -1,  -1,  -1,  -1,
        -1,  -1,  -1,  -1,  -1,  -1,  -1,   -1,  -1,  -1,  -1,  -1,  -1,  -1,  -1,  -1,  -1,  -1,  -1,  -1,  -1,  -1,  -1,  -1,  -1,  -1,  -1,  -1,  -1,  -1
      ],
      "tileset": "dungeon"
    }
  }
}
