{
  "tileLayers": {
    "floor": {
      "tiles": [
        408, 408, 408, 408, 408, 408, 408, 408, 408, 408, 408, 408, 408, 408, 408, 408, 408, 408, 408, 408, 408, 408, 408, 408, 408, 408, 408, 408, 408, 408,
        408, 408, 408, 408, 408, 408, 408, 408, 408, 408, 408, 408, 408, 408, 408, 408, 408, 408, 408, 408, 408, 408, 408, 408, 408, 408, 408, 408, 408, 408,
        241, 233, 235, 291, 233, 235, 241, 293, 350, 234, 409, 241, 291, 408, 408, 408, 408, 408, 408, 408, 408, 408, 408, 408, 408, 408, 408, 408, 408, 408,
        241, 934, 235, 291, 233, 235, 241, 293, 350, 234, 409, 241, 291, 408, 408, 408, 408, 408, 408, 408, 408, 408, 408, 408, 408, 408, 408, 408, 408, 408,
        241, 350, 409, 241, 292, 233, 235, 242, 293, 350, 234, 233, 349, 408, 408, 408, 408, 408, 408, 408, 408, 408, 408, 408, 408, 408, 408, 408, 408, 408,
        241, 242, 234, 349, 293, 242, 242, 233, 409, 235, 234, 241, 233, 408, 408, 408, 408, 408, 408, 408, 408, 408, 408, 408, 408, 408, 408, 408, 408, 408,
        241, 233, 235, 291, 233, 235, 241, 293, 350, 234, 409, 241, 291, 408, 408, 408, 408, 408, 408, 408, 408, 408, 408, 408, 408, 408, 408, 408, 408, 408,
        241, 233, 234, 235, 241, 242, 233, 234, 235, 241, 242, 234, 235, 408, 408, 408, 408, 408, 408, 408, 408, 408, 408, 408, 408, 408, 408, 408, 408, 408,
        241, 242, 234, 349, 293, 242, 242, 233, 409, 235, 234, 241, 233, 408, 408, 408, 408, 408, 408, 408, 408, 408, 408, 408, 408, 408, 408, 408, 408, 408,
        241, 350, 409, 241, 292, 233, 235, 242, 293, 350, 234, 233, 349, 408, 408, 408, 408, 408, 408, 408, 408, 408, 408, 408, 408, 408, 408, 408, 408, 408,
        241, 233, 234, 235, 241, 242, 233, 234, 235, 241, 242, 234, 235, 408, 408, 408, 408, 408, 408, 408, 408, 408, 408, 408, 408, 408, 408, 408, 408, 408,
        241, 242, 234, 349, 293, 242, 242, 233, 409, 235, 234, 241, 233, 408, 408, 408, 408, 408, 408, 408, 408, 408, 408, 408, 408, 408, 408, 408, 408, 408,
        241, 233, 234, 235, 241, 242, 233, 234, 235, 241, 242, 234, 235, 291, 233, 235, 241, 233, 234, 235, 233, 242, 233, 234, 235, 241, 242, 234, 235, 241,
        241, 350, 409, 241, 292, 233, 235, 242, 293, 350, 234, 233, 349, 242, 234, 349, 293, 242, 350, 409, 241, 292, 233, 235, 242, 293, 350, 234, 233, 241,
        241, 233, 235, 291, 233, 235, 241, 293, 350, 234, 409, 241, 291, 234, 409, 241, 291, 234, 242, 409, 233, 350, 233, 350, 409, 291, 349, 291, 350, 241,
        241, 242, 234, 349, 293, 242, 242, 233, 409, 235, 234, 241, 233, 293, 235, 291, 234, 242, 234, 349, 293, 242, 242, 233, 235, 235, 409, 241, 233, 241,
        241, 233, 235, 291, 233, 235, 241, 293, 350, 234, 409, 241, 291, 242, 409, 350, 233, 234, 242, 409, 233, 350, 233, 350, 234, 291, 349, 291, 350, 241,
        241, 242, 234, 349, 293, 242, 242, 233, 409, 235, 234, 241, 233, 293, 235, 291, 234, 242, 234, 349, 293, 242, 242, 233, 409, 235, 234, 241, 409, 241,
        241, 350, 409, 241, 292, 233, 235, 242, 293, 350, 234, 233, 349, 233, 241, 293, 349, 350, 409, 241, 292, 233, 235, 242, 293, 350, 234, 233, 349, 241,
        241, 233, 235, 291, 233, 235, 241, 293, 350, 234, 409, 241, 291, 291, 235, 234, 349, 234, 242, 409, 233, 350, 233, 350, 409, 291, 349, 291, 350, 241,
        408, 408, 408, 408, 408, 408, 408, 408, 408, 408, 408, 408, 408, 233, 234, 235, 241, 408, 408, 408, 408, 408, 408, 408, 408, 408, 408, 408, 408, 408,
        408, 408, 408, 408, 408, 408, 408, 408, 408, 408, 408, 408, 408, 408, 408, 408, 408, 408, 408, 408, 408, 408, 408, 408, 408, 408, 408, 408, 408, 408
      ],
      "tileset": "dungeon"
    },
    "darkWalls": {
      "tiles": [
         -1,  -1,  -1,  -1,  -1,  -1,  -1,  -1,  -1,  -1,  -1,  -1,  -1,  -1,  -1,  -1,  -1,  -1,  -1,  -1,  -1,  -1,  -1,  -1,  -1,  -1,  -1,  -1,  -1,  -1,
         -1,  -1,  -1,  -1,  -1,  -1,  -1,  -1,  -1,  -1,  -1,  -1,  -1,  -1,  -1,  -1,  -1,  -1,  -1,  -1,  -1,  -1,  -1,  -1,  -1,  -1,  -1,  -1,  -1,  -1,
        756, 873, 873, 117, 120, 118, 120, 175, 120, 176, 120, 873, 872,  -1,  -1,  -1,  -1,  -1,  -1,  -1,  -1,  -1,  -1,  -1,  -1,  -1,  -1,  -1,  -1,  -1,
         -1,  -1,  -1,  -1,  -1,  -1,  -1,  -1,  -1,  -1,  -1,  -1,  -1,  -1,  -1,  -1,  -1,  -1,  -1,  -1,  -1,  -1,  -1,  -1,  -1,  -1,  -1,  -1,  -1,  -1,
         -1,  -1,  -1,  -1,  -1,  -1,  -1,  -1,  -1,  -1,  -1,  -1,  -1,  -1,  -1,  -1,  -1,  -1,  -1,  -1,  -1,  -1,  -1,  -1,  -1,  -1,  -1,  -1,  -1,  -1,
         -1,  -1,  -1,  -1,  -1,  -1,  -1,  -1,  -1,  -1,  -1,  -1,  -1,  -1,  -1,  -1,  -1,  -1,  -1,  -1,  -1,  -1,  -1,  -1,  -1,  -1,  -1,  -1,  -1,  -1,
         -1,  -1,  -1,  -1,  -1,  -1,  -1,  -1,  -1,  -1,  -1,  -1,  -1,  -1,  -1,  -1,  -1,  -1,  -1,  -1,  -1,  -1,  -1,  -1,  -1,  -1,  -1,  -1,  -1,  -1,
         -1,  -1,  -1,  -1,  -1,  -1,  -1,  -1,  -1,  -1,  -1,  -1,  -1,  -1,  -1,  -1,  -1,  -1,  -1,  -1,  -1,  -1,  -1,  -1,  -1,  -1,  -1,  -1,  -1,  -1,
         -1,  -1,  -1,  -1,  -1,  -1,  -1,  -1,  -1,  -1,  -1,  -1,  -1,  -1,  -1,  -1,  -1,  -1,  -1,  -1,  -1,  -1,  -1,  -1,  -1,  -1,  -1,  -1,  -1,  -1,
         -1,  -1,  -1,  -1,  -1,  -1,  -1,  -1,  -1,  -1,  -1,  -1,  -1,  -1,  -1,  -1,  -1,  -1,  -1,  -1,  -1,  -1,  -1,  -1,  -1,  -1,  -1,  -1,  -1,  -1,
         -1,  -1,  -1,  -1,  -1,  -1,  -1,  -1,  -1,  -1,  -1,  -1,  -1,  -1,  -1,  -1,  -1,  -1,  -1,  -1,  -1,  -1,  -1,  -1,  -1,  -1,  -1,  -1,  -1,  -1,
         -1,  -1,  -1,  -1,  -1,  -1,  -1,  -1,  -1,  -1,  -1,  -1,  -1,  -1,  -1,  -1,  -1,  -1,  -1,  -1,  -1,  -1,  -1,  -1,  -1,  -1,  -1,  -1,  -1,  -1,
         -1,  -1,  -1,  -1,  -1,  -1,  -1,  -1,  -1,  -1,  -1,  -1,  -1, 872, 178, 872, 178, 872, 178, 872, 178, 872, 178, 872, 178, 872, 178, 872, 178, 816,
         -1,  -1,  -1,  -1,  -1,  -1,  -1,  -1,  -1,  -1,  -1,  -1,  -1,  -1,  -1,  -1,  -1,  -1,  -1,  -1,  -1,  -1,  -1,  -1,  -1,  -1,  -1,  -1,  -1,  -1,
         -1,  -1,  -1,  -1,  -1,  -1,  -1,  -1,  -1,  -1,  -1,  -1,  -1,  -1,  -1,  -1,  -1,  -1,  -1,  -1,  -1,  -1,  -1,  -1,  -1,  -1,  -1,  -1,  -1,  -1,
         -1,  -1,  -1,  -1,  -1,  -1,  -1,  -1,  -1,  -1,  -1,  -1,  -1,  -1,  -1,  -1,  -1,  -1,  -1,  -1,  -1,  -1,  -1,  -1,  -1,  -1,  -1,  -1,  -1,  -1,
         -1,  -1,  -1,  -1,  -1,  -1,  -1,  -1,  -1,  -1,  -1,  -1,  -1,  -1,  -1,  -1,  -1,  -1,  -1,  -1,  -1,  -1,  -1,  -1,  -1,  -1,  -1,  -1,  -1,  -1,
         -1,  -1,  -1,  -1,  -1,  -1,  -1,  -1,  -1,  -1,  -1,  -1,  -1,  -1,  -1,  -1,  -1,  -1,  -1,  -1,  -1,  -1,  -1,  -1,  -1,  -1,  -1,  -1,  -1,  -1,
         -1,  -1,  -1,  -1,  -1,  -1,  -1,  -1,  -1,  -1,  -1,  -1,  -1,  -1,  -1,  -1,  -1,  -1,  -1,  -1,  -1,  -1,  -1,  -1,  -1,  -1,  -1,  -1,  -1,  -1,
         -1,  -1,  -1,  -1,  -1,  -1,  -1,  -1,  -1,  -1,  -1,  -1,  -1,  -1,  -1,  -1,  -1,  -1,  -1,  -1,  -1,  -1,  -1,  -1,  -1,  -1,  -1,  -1,  -1,  -1,
        872, 873, 872, 873, 872, 873, 872, 873, 872, 873, 872, 873, 872, 873, 872, 873, 872, 873, 872, 873, 872, 873, 872, 873, 872, 873, 872, 873, 872, 873,
        872, 873, 872, 873, 872, 873, 872, 873, 872, 873, 872, 873, 872, 873, 872, 873, 872, 873, 872, 873, 872, 873, 872, 873, 872, 873, 872, 873, 872, 873
      ],
      "tileset": "dungeon"
    },
    "lightWalls": {
      "tiles": [
         -1,  -1,  -1,  -1,  -1,  -1,  -1,  -1,  -1,  -1,  -1,  -1,  -1,  -1,  -1,  -1,  -1,  -1,  -1,  -1,  -1,  -1,  -1,  -1,  -1,  -1,  -1,  -1,  -1,  -1,
        698, 875, 875, 875, 875, 875, 875, 875, 875, 875, 875, 875, 699, 697,  -1,  -1,  -1,  -1,  -1,  -1,  -1,  -1,  -1,  -1,  -1,  -1,  -1,  -1,  -1,  -1,
         -1,  -1,  -1,  -1,  -1,  -1,  -1,  -1,  -1,  -1,  -1,  -1,  -1, 755,  -1,  -1,  -1,  -1,  -1,  -1,  -1,  -1,  -1,  -1,  -1,  -1,  -1,  -1,  -1,  -1,
        755,  -1,  -1,  -1,  -1,  -1,  -1,  -1,  -1,  -1,  -1,  -1,  -1, 755,  -1,  -1,  -1,  -1,  -1,  -1,  -1,  -1,  -1,  -1,  -1,  -1,  -1,  -1,  -1,  -1,
        755,  -1,  -1,  -1,  -1,  -1,  -1,  -1,  -1,  -1,  -1,  -1,  -1, 755,  -1,  -1,  -1,  -1,  -1,  -1,  -1,  -1,  -1,  -1,  -1,  -1,  -1,  -1,  -1,  -1,
        755,  -1,  -1,  -1,  -1,  -1,  -1,  -1,  -1,  -1,  -1,  -1,  -1, 755,  -1,  -1,  -1,  -1,  -1,  -1,  -1,  -1,  -1,  -1,  -1,  -1,  -1,  -1,  -1,  -1,
        755,  -1,  -1,  -1,  -1,  -1,  -1,  -1,  -1,  -1,  -1,  -1,  -1, 755,  -1,  -1,  -1,  -1,  -1,  -1,  -1,  -1,  -1,  -1,  -1,  -1,  -1,  -1,  -1,  -1,
        755,  -1,  -1,  -1,  -1,  -1,  -1,  -1,  -1,  -1,  -1,  -1,  -1, 755,  -1,  -1,  -1,  -1,  -1,  -1,  -1,  -1,  -1,  -1,  -1,  -1,  -1,  -1,  -1,  -1,
        755,  -1,  -1,  -1,  -1,  -1,  -1,  -1,  -1,  -1,  -1,  -1,  -1, 755,  -1,  -1,  -1,  -1,  -1,  -1,  -1,  -1,  -1,  -1,  -1,  -1,  -1,  -1,  -1,  -1,
        755,  -1,  -1,  -1,  -1,  -1,  -1,  -1,  -1,  -1,  -1,  -1,  -1, 755,  -1,  -1,  -1,  -1,  -1,  -1,  -1,  -1,  -1,  -1,  -1,  -1,  -1,  -1,  -1,  -1,
        755,  -1,  -1,  -1,  -1,  -1,  -1,  -1,  -1,  -1,  -1,  -1,  -1, 755,  -1,  -1,  -1,  -1,  -1,  -1,  -1,  -1,  -1,  -1,  -1,  -1,  -1,  -1,  -1,  -1,
        755,  -1,  -1,  -1,  -1,  -1,  -1,  -1,  -1,  -1,  -1,  -1,  -1, 814, 875, 875, 875, 875, 875, 875, 875, 875, 875, 875, 875, 875, 875, 875, 699, 699,
        755,  -1,  -1,  -1,  -1,  -1,  -1,  -1,  -1,  -1,  -1,  -1,  -1,  -1,  -1,  -1,  -1,  -1,  -1,  -1,  -1,  -1,  -1,  -1,  -1,  -1,  -1,  -1,  -1, 697,
        755,  -1,  -1,  -1,  -1,  -1,  -1,  -1,  -1,  -1,  -1,  -1,  -1,  -1,  -1,  -1,  -1,  -1,  -1,  -1,  -1,  -1,  -1,  -1,  -1,  -1,  -1,  -1,  -1, 754,
        755,  -1,  -1,  -1,  -1,  -1,  -1,  -1,  -1,  -1,  -1,  -1,  -1,  -1,  -1,  -1,  -1,  -1,  -1,  -1,  -1,  -1,  -1,  -1,  -1,  -1,  -1,  -1,  -1, 754,
        755,  -1,  -1,  -1,  -1,  -1,  -1,  -1,  -1,  -1,  -1,  -1,  -1,  -1,  -1,  -1,  -1,  -1,  -1,  -1,  -1,  -1,  -1,  -1,  -1,  -1,  -1,  -1,  -1, 754,
        755,  -1,  -1,  -1,  -1,  -1,  -1,  -1,  -1,  -1,  -1,  -1,  -1,  -1,  -1,  -1,  -1,  -1,  -1,  -1,  -1,  -1,  -1,  -1,  -1,  -1,  -1,  -1,  -1, 754,
        755,  -1,  -1,  -1,  -1,  -1,  -1,  -1,  -1,  -1,  -1,  -1,  -1,  -1,  -1,  -1,  -1,  -1,  -1,  -1,  -1,  -1,  -1,  -1,  -1,  -1,  -1,  -1,  -1, 754,
        755,  -1,  -1,  -1,  -1,  -1,  -1,  -1,  -1,  -1,  -1,  -1,  -1,  -1,  -1,  -1,  -1,  -1,  -1,  -1,  -1,  -1,  -1,  -1,  -1,  -1,  -1,  -1,  -1, 754,
        759,   2,   3,   1,   2,   3,   1,   2,   3,   1,   2,   3,   1,   2,   3,   1,   2,   3,   1,   2,   3,   1,   2,   3,   1,   2,   3,   1,   2, 758,
         -1,  -1,  -1,  -1,  -1,  -1,  -1,  -1,  -1,  -1,  -1,  -1,  -1,  -1,  -1,  -1,  -1,  -1,  -1,  -1,  -1,  -1,  -1,  -1,  -1,  -1,  -1,  -1,  -1,  -1,
         -1,  -1,  -1,  -1,  -1,  -1,  -1,  -1,  -1,  -1,  -1,  -1,  -1,  -1,  -1,  -1,  -1,  -1,  -1,  -1,  -1,  -1,  -1,  -1,  -1,  -1,  -1,  -1,  -1,  -1
      ],
      "tileset": "dungeon"
    },
    "decorations": {
      "tiles": [
        -1,  -1,  -1,  -1,  -1,  -1,  -1,   -1,  -1,  -1,  -1,  -1,  -1,  -1,  -1,  -1,  -1,  -1,  -1,  -1,  -1,  -1,  -1,  -1,  -1,  -1,  -1,  -1,  -1,  -1,
        -1,  -1,  -1,  -1,  -1,  -1,  -1,   -1,  -1,  -1,  -1,  -1,  -1,  -1,  -1,  -1,  -1,  -1,  -1,  -1,  -1,  -1,  -1,  -1,  -1,  -1,  -1,  -1,  -1,  -1,
        -1, -1,  -1,  1458,  -1,  -1,  -1,   -1,  -1,  -1,  -1,  -1,1458,  -1,  -1,  -1,  -1,  -1,  -1,  -1,  -1,  -1,  -1,  -1,  -1,  -1,  -1,  -1,  -1,  -1,
        -1, -1,  1516,  -1,  -1,  -1,  -1,   -1,  -1,  -1,  -1,  -1,1516,  -1,  -1,  -1,  -1,  -1,  -1,  -1,  -1,  -1,  -1,  -1,  -1,  -1,  -1,  -1,  -1,  -1,
        -1,  -1,  -1,  -1,  -1,  -1,  -1,   -1,  -1,  -1,  -1,  -1,  -1,  -1,  -1,  -1,  -1,  -1,  -1,  -1,  -1,  -1,  -1,  -1,  -1,  -1,  -1,  -1,  -1,  -1,
        -1,  -1,  -1,  -1,  -1,  -1,  -1,   -1,  -1,  -1,  -1,  -1,  -1,  -1,  -1,  -1,  -1,  -1,  -1,  -1,  -1,  -1,  -1,  -1,  -1,  -1,  -1,  -1,  -1,  -1,
        -1,  -1,  -1,  -1,  -1,  -1,  -1,   -1,  -1,  -1,  -1,  -1,  -1,  -1,  -1,  -1,  -1,  -1,  -1,  -1,  -1,  -1,  -1,  -1,  -1,  -1,  -1,  -1,  -1,  -1,
        -1,  -1,  -1,  -1,  -1,  -1,  -1,   -1,  -1,  -1,  -1,  -1,  -1,  -1,  -1,  -1,  -1,  -1,  -1,  -1,  -1,  -1,  -1,  -1,  -1,  -1,  -1,  -1,  -1,  -1,
        -1,  -1,  -1,  -1,  -1,  -1,  -1,   -1,  -1,  -1,  -1,  -1,  -1,  -1,  -1,  -1,  -1,  -1,  -1,  -1,  -1,  -1,  -1,  -1,  -1,  -1,  -1,  -1,  -1,  -1,
        -1,  -1,  -1,  -1,  -1,  -1,  -1,   -1,  -1,  -1,  -1,  -1,  -1,  -1,  -1,  -1,  -1,  -1,  -1,  -1,  -1,  -1,  -1,  -1,  -1,  -1,  -1,  -1,  -1,  -1,
        -1,  -1,  -1,  -1,  -1,  -1,  -1,   -1,  -1,  -1,  -1,  -1,  -1,  -1,  -1,  -1,  -1,  -1,  -1,  -1,  -1,  -1,  -1,  -1,  -1,  -1,  -1,  -1,  -1,  -1,
        -1,  -1,  -1,  -1,  -1,  -1,  -1,   -1,  -1,  -1,  -1,  -1,  -1, 236,  -1, 236,  -1, 236,  -1, 236,  -1, 236,  -1, 236,  -1, 236,  -1, 236,  -1,  -1,
        -1,  -1,  -1,  -1,  -1,  -1,  -1,   -1,  -1,  -1,  -1,  -1,1458, 410,  -1, 410,  -1, 410,  -1, 410,  -1, 410,  -1, 410,  -1, 410,  -1, 410,1458,  -1,
        -1,  -1,  -1,  -1,  -1,  -1,  -1,   -1,  -1,  -1,  -1,  -1,1516, 468,  -1, 468,  -1, 468,  -1, 468,  -1, 468,  -1, 468,  -1, 468,  -1, 468,1516,  -1,
        -1,  -1,  -1,  -1,  -1,  -1,  -1,   -1,  -1,  -1,  -1,  -1,  -1, 987,1047,1047,1047,1047,1047,1047,1047,1047,1047,1047,1047,1047,1047, 988,  -1,  -1,
        -1,  -1,  -1,  -1,  -1,  -1,  -1,   -1,  -1,  -1,  -1,  -1,  -1,1045, 989, 989, 989, 989, 989, 989, 989, 989, 989, 989, 989, 989, 989,1046,  -1,  -1,
        -1,  -1,  -1,  -1,  -1,  -1,  -1,   -1,  -1,  -1,  -1,  -1,  -1,1045, 989, 989, 989, 989, 989, 989, 989, 989, 989, 989, 989, 989, 989,1046,  -1,  -1,
        -1,  -1,  -1,  -1,  -1,  -1,  -1,   -1,  -1,  -1,  -1,  -1,  -1,1045, 989, 989, 989, 989, 989, 989, 989, 989, 989, 989, 989, 989, 989,1046,  -1,  -1,
        -1,1458,  -1,  -1,  -1,  -1,  -1,   -1,  -1,  -1,  -1,  -1,  -1,1103,1105,1105,1105,1105,1105,1105,1105,1105,1105,1105,1105,1105,1105,1104,1458,  -1,
        -1,1516,  -1,  -1,  -1,  -1,  -1,   -1,  -1,  -1,  -1,  -1,  -1,  -1,  -1,  -1,  -1,  -1,  -1,  -1,  -1,  -1,  -1,  -1,  -1,  -1,  -1,  -1,1516,  -1,
        -1,  -1,  -1,  -1,  -1,  -1,  -1,   -1,  -1,  -1,  -1,  -1,  -1,  -1,  -1,  -1,  -1,  -1,  -1,  -1,  -1,  -1,  -1,  -1,  -1,  -1,  -1,  -1,  -1,  -1,
        -1,  -1,  -1,  -1,  -1,  -1,  -1,   -1,  -1,  -1,  -1,  -1,  -1,  -1,  -1,  -1,  -1,  -1,  -1,  -1,  -1,  -1,  -1,  -1,  -1,  -1,  -1,  -1,  -1,  -1
      ],
      "tileset": "dungeon"
    }
  }
}